########
# @    #
# #$#  #
# $ .  #
#  .#  #
# $    #
########
