########
#      #
# @ $  #
#   .  #
#      #
########
